Width 17
Height 10
5 0 0 0 0 0 0 0 0 0 0 0 0 0 0 0 5
5 0 0 0 0 0 0 0 0 0 0 0 0 0 0 0 5
5 0 0 0 0 0 0 0 0 0 0 0 0 0 0 0 5
5 0 0 1 1 1 0 0 0 0 1 1 1 1 0 0 5
5 0 0 0 0 0 0 0 0 0 0 0 0 0 0 0 5
5 0 0 0 0 0 1 1 1 1 1 0 0 0 0 0 5
5 1 1 0 0 0 0 0 0 0 0 0 0 0 1 1 5
5 0 0 0 0 0 0 0 0 0 0 0 0 0 0 0 5
2 2 2 2 2 2 2 2 2 2 2 2 2 2 2 2 2
0 0 0 0 0 0 0 0 0 0 0 0 0 0 0 0 0
